NO textures/blue_tnt.png


SO textures/diamond_block.png


WE textures/calcite.png


EA textures/glass.png


DO textures/iron_door.png


F 185,211,238


C 204,229,255

1111111111111111
1000000000000001
1111111111111101
1000000000000001
1011111111111111
100000000C000001
1111111111111101
10000O0000000001
1011111111111111
1000000000000001
11111111111111N1
1111111111111111
