NO textures/example_no.webp


SO textures/example_so.webp


WE textures/example_we.webp


EA textures/example_ea.webp


F 9,100,90


C 225,30,0

1111111111111111
1000000000000001
1111111111111101
1000000000000001
1011111111111111
1000000000000001
1111111111111101
1000000000000001
1011111111111111
1000000000000001
11111111111111N1
1111111111111111
