NO textures/example_no.webp


SO textures/example_so.webp


WE textures/example_we.webp


EA textures/example_ea.webp


F 9,100,90


C 225,30,0

11111111111111
10000001000001
10010010000001
11000101000001
10000001000001
10010010000001
11000101000001
10000001000001
10010010000001
11000101000001
10000001000001
10010010000001
11000101000001
100000000N0001
11111111111111
