NO textures/example_no.webp


SO textures/example_so.webp


WE textures/example_we.webp


EA textures/example_ea.webp


F 9,100,90


C 225,30,0

11111111111
10000001001
10010010001
11000101001
10001001001
10010000001
100000000N1
11111111111
